12 More Rules for Life - Jordan Peterson
12 Rules for Life - Jordan Peterson
A Brief History of Time - Stephen Hawking
A Farewell to Arms - Ernest Hemingway
A Random Walk Down Wall Street - Burton G. Malkiel
Adventures of Huckleberry Finn - Mark Twain
All About Love - bell hooks
Animal Farm - George Orwell
Anna Karenina - Leo Tolstoy
Anne of Green Gables - L.M. Montgomery
Atomic Habits - James Clear
Black Beauty - Anna Sewell
Boundaries of the Soul: The Practice of Jung's Psychology - June Singer
Brave New World - Aldous Huxley
Cashflow Quadrant - Robert Kiyosaki
Charlotte's Web - E.B. White
Chimpanzee Politics: Power and Sex Among Apes - Frans de Waal
Diary of a Wimpy Kid - Jeff Kinney
East of Eden - John Steinbeck
Ego is the Enemy - Ryan Holiday
Elon Musk: Biography - Walter Isaacson
Emotional Intelligence - Daniel Goleman
Euthyphro - Plato
Flowers for Algernon - Daniel Keyes
From Good to Great - Jim Collins
Genius: The Natural History of Creativity - H.J. Eysenck
Getting Started with 3D Printing - Liza Wallach Kloski, Nick Kloski
Go the Fk to Sleep** - Adam Mansbach
Good to Great - Jim Collins
Great Again: How to Fix Our Crippled America - Donald J. Trump
How to Avoid a Climate Disaster - Bill Gates
How to Get Rich - Donald Trump
How to Talk to Anyone - Leil Lowndes
I, Claudius - Robert Graves
Ikigai: The Japanese Secret to a Long and Happy Life - Héctor García and Francesc Miralles
In Search of Excellence - Tom Peters and Robert H. Waterman Jr.
Influence: The Psychology of Persuasion - Robert B. Cialdini
Introduction to Deep Learning - Eugene Charniak
It's the Way You Say It: Becoming Articulate, Well-Spoken, and Clear - Carol A. Fleming
Jonathan Livingston Seagull - Richard Bach
Jung Memories, Dreams, Reflections - Carl Jung
Life 3.0 - Max Tegmark
Life at the Bottom: The Worldview That Makes the Underclass - Theodore Dalrymple
Make America Great Again - Donald Trump
Make: Drones: Teach an Arduino to Fly - David McGriffy
Mama's Last Hug: Animal Emotions and What They Tell Us about Ourselves - Frans de Waal
Man and His Symbols - Carl Jung
Man's Search for Meaning - Viktor E. Frankl
McDonald's: Behind the Arches - John F. Love
Midas Touch: Why Some Entrepreneurs Get Rich - And Why Most Don't - Donald Trump and Robert Kiyosaki
Misery - Stephen King
Never Split the Difference: Negotiating as If Your Life Depended on It - Chris Voss
Nineteen Eighty-Four (1984) - George Orwell
Normal People - Sally Rooney
Notes from the Underground - Fyodor Dostoevsky
Of Mice and Men - John Steinbeck
On Becoming a Person: A Therapist's View of Psychotherapy - Carl Rogers
On Writing: A Memoir of the Craft - Stephen King
One Flew Over the Cuckoo's Nest - Ken Kesey
One Up on Wall Street - Peter Lynch
Ordinary Men: Reserve Police Battalion 101 and the Final Solution in Poland - Christopher R. Browning
Outlive - Peter Attia
Philosophy Looks at Chess - Benjamin Hale
Plato's Republic - Plato
Play, Dreams, and Imitation in Childhood - Jean Piaget
Point Counterpoint - Aldous Huxley
Postmodernism Explained - Richard Appignanesi
Quantum Supremacy - Michael Brooks
Quran
Rich Dad Poor Dad - Robert Kiyosaki
Rich Dad's Guide to Investing - Robert Kiyosaki
Robopocalypse - Daniel H. Wilson
Rocket Science: A Beginner’s Guide to the Fundamentals of Spaceflight - Andrew Rader
Seneca: Letters from a Stoic - Seneca
Steve Jobs - Walter Isaacson
Stuff Matters: Exploring the Marvelous Materials That Shape Our Man-Made World - Mark Miodownik
Superintelligence - Nick Bostrom
The 4-Hour Work Week - Tim Ferriss
The 5 AM Club - Robin Sharma
The 80/20 Principle: The Secret to Achieving More with Less
The Adventures of Huckleberry Finn - Mark Twain
The Alchemist - Paulo Coelho
The Alignment Problem: Machine Learning and Human Values - Brian Christian
The Anxious Generation
The Art of War - Sun Tzu
The Art of the Deal - Donald Trump
The Automatic Millionaire - David Bach
The Bell Curve - Richard J. Herrnstein and Charles Murray
The Bible - Various Authors
The Catcher in the Rye - J.D. Salinger
The Communist Manifesto - Karl Marx and Friedrich Engels
The Complete Book of Chess Strategy: Grandmaster Techniques from A to Z - Jeremy Silman
The Courage to Be Disliked - Ichiro Kishimi and Fumitake Koga
The Gingerbread Man - Anon
The Great Gatsby - F. Scott Fitzgerald
The Greatest Story Ever Told - Fulton Oursler
The Hitchhiker’s Guide to the Galaxy - Douglas Adams
The Hite Report: A Nationwide Study of Female Sexuality - Shere Hite
The Hobbit - J.R.R. Tolkien
The Interpretation of Dreams - Sigmund Freud
The Language of Creation - Jonathan Pageau
The Lean Startup - Eric Ries
The Lion, the Witch, and the Wardrobe - C.S. Lewis
The Little Book That Still Beats the Market - Joel Greenblatt
The Little Prince - Antoine de Saint-Exupéry
The Maker's Guide to the Zombie Apocalypse: Defend Your Base with Simple Circuits, Arduino, and Raspberry Pi - Simon Monk
The Mating Mind - Geoffrey Miller
The Millionaire Fastlane - MJ DeMarco
The Millionaire Mind - Thomas J. Stanley
The Moral Judgment of the Child - Jean Piaget
The Old Man and the Sea - Ernest Hemingway
The Philosophy Book - Will Buckingham
The Prince - Niccolò Machiavelli
The Simple Path to Wealth - JL Collins
The Speed of Thought - Bill Gates
The Tale of Peter Rabbit - Beatrix Potter
The Unplugged Alpha - Richard Cooper
The User Illusion - Tor Nørretranders
The Very Hungry Caterpillar - Eric Carle
The War of Art: Break Through the Blocks and Win Your Inner Creative Battles - Steven Pressfield
The Woman in Me - Britney Spears
The Wright Brothers - David McCullough
Think Like a Champion - Donald Trump
Trump: How to Be Rich - Donald Trump
Watership Down - Richard Adams
What Shall We Do Then? - Leo Tolstoy
Who Moved My Cheese - Spencer Johnson
Rich Kid, Smart Kid by Robert Kiyosaki and Sharon Lechter
Why Smart People Do Dumb Things - Dr. R. L. C. Bawden
Why We Sleep - Matthew Walker
Why We Want You to Be Rich - Donald Trump and Robert Kiyosaki
Your Brain on Porn - Gary Wilson
Zen - Alan Watts
Zero to One - Peter Thiel